bath => bath
bathing => bathing
beer => beer
bodies => bodies
body => body
bra => bra
brie => brie
cloak => cloak
cloth => cloth
clothes => clothes
clothing => clothing
coat => coat
coated => coated
cover => cover
dress => dress
fish => fish
fishing => fishing
foam => foam
foamed => foamed
herring => herring
lead => lead
led => led
mobile => mobile
one => one
onion => onion
organ => organ
organic => organic
package => package
packaging => packaging
paint => paint
painting => painting
sand => sand
sanded => sanded
sanding => sanding
stick => stick
sticker => sticker
stock => stock
stockings => stockings
stretch => stretch
stretched => stretched
stretcher => stretcher
white => white
whiting => whiting
